102
E.X...X..XX..XXXX..XX..X...X..XXX...XXXX.XX.XXXXX..........X...XXXX....X...XX..XXXXX..X..XX.X.....X..X
XXX......XX....X....XXX....XXXX.XXX.XXX...XXXX.X.X...X...X.X..XX..XX..XXXX.XXXX...X.XXX...X..XX...XXXX
...X...XX...X.X.....XXX.X..XXX..X....XXXXX.XX.XX..XXXXX.X..X.X..X..XX..X.XX....XXXXXX....XX....X...X.X
XX....XX.......XXX.X...X...X....XX.X....X.XX...XXX..X.X..XX.X..XX....X.XXXX.X..XXXXXXX..XX...X...XX.X.
..X..X...XX.XXXXXX.XXX..X.XXX.X.XX...X..XXXX.X...X.X.X.X.X....XXX....X.......X.....XX.X.X.XXX..XX.X...
XXX.....XX.XXX.XX.X..XXX..XXX.X..X..XX.XXXX.....X.XXX.XXX.XX..X.XXXX....X..X.XXXXXXXXXXXXXX.X.X....X..
X.X.XXXX.XX.X.XXX.XX...XX.XXX.XX.XX...XX.XX..XXXX.XX..X....XX.XX..XXX.XXXX.X..XX.XX.X..XXX..XX..X.X.X.
.X.XXXXX..XX...XXXXXX..XX.X.........XXX.X..XXX..X.X..XXX.XX..X...X..X..XXX...X..XX....X.X..XX.X.XX.X.X
.X.XXX..XX.XX.XXXX..XX.XX.X.X..XX...XX....X...X.XX.X..XX.XXX..X.XX.X...XXXXXXX.XXX.X.XX..XXX.XX....XX.
..XXX.X..X.....XXX.XXXX..XXXXXX...XX.X.......XX.X.X..X.X....XXX...XXX.XX..X.X.XXX.X..XX..X...XXXXX...X
.X...X.X....XXXXX.........XXX.X.X...X...XX.X...XX.X..X..XX.X.X...X....XXX..X..XX...X..X.XXXX.XX.XXXX..
.X...XXXX..X..XX..X..X..XXX..XX..XX..X.......X..X.X...X.XX.X..X...XXXXX.....XX.X..XXXX.X..X.XXXX.X.X..
.X..XX.X...X.XX..XXX.X....XXX...X..X...XX..X.XXXXX.XX.XX..X.X.XXX....X.XXXX..XX.X.X....XX...X.......X.
XX.XX...XX.X.XX....XXX..XXXXXXXX.X..X.XXX....XX...X.X..X....X.X.....X.XXX.XX.....XXX.XXX...XXXX..XXXX.
.X.XXX.X.XX..X.X.XXX.X..XX.X...XX..X.....X....X....XX.XX.X.X..X.XX..XX..XX.XXXX.XXXX..X.X..XX..XX...XX
..X..X.X...X.XXXXXXXXX.....X....X.X.XXXXX.XXX.X.XX...XXX..XXX.XX.X.XXX..XX.XXXXXXX.X.X..XXXXX.X....XXX
.XX....X.XX.X....X.X.XX.XX.X...XXXX.X.X...X.X......XX.XX...X...XX.X.X..XX.XX.XXX......XXX..X.X..X.X.X.
.X..X....XXX.X.XXXXX...X.XX.X.X.X.XX.X.X.XX..X.X.X.XX.X.X..X....X.X.X........X.XX..XXX...X.X.X...X.X.X
XX.X....X.X.X.X.XXX.....XXXXXX.XX.X....X.X.XX.X...X..X..XX...X.X.X..X..XXXXX..XX....XX...XX.XXX....X..
X.....XX...XX.X...X.XX.....X..X...XXX..X.XX...XXXXX.XX...X..X.X.XXXXXXX..X.XXX.XX.X..XX.XXXX..X.XX...X
XX......X.X....XXXX.XX.X....XXX.XXXXX.XX...XX..X..XX...X.X.XXXXX.XX.X...X.XX.XX.XXX........XX.X.XXX.XX
.XX.....XX.X.X..X...XXXX..XXXX.XXXX.X..X.X....X.X.X.XXXXXX.XX.X.X.XXXX....XX.XXX.X.X.XX..XX.X.X.XXXX.X
XXX....XXXXX..X.......X.XX..X.X.X.XX.XXX.X.XX....X.XX.......XX.....XXX.X.X....XX.X....XXXX.X.XX..X.X.X
XX...XX..X..XXXX...X..X..X.X..X......XXXX.X...X...XXX.X....X...X.XX.X.XXXXX...X..X....X..........X..XX
X.X.X.X....X.X..X.X..X....XX.X.XXX....X.XX.XXX.XXX.......X.X...XX.X.......X..X.XXXXX.XXXXX.XX..XXXXXX.
XXX.XX.X.....X....XX.XXX.XXXXX..X...X.X...X.X......XXX.X...XX..XXX.XX.XX.....XXX..XX....X...XXX.XXXX..
......X.X.XX...X...XX..XX.X.X.X.XX...XXXX....X..X.X.XXXXXX..X..X.XX..XX.X.X..XX.XXX.X.XX......XX.XXX.X
X.X.X...X..XXX..XXXXX..X..XX.X....X..XX..XX..X.X....XX.XXX........X.XXX.X...X..XX..X....XXXXXXX.XX..X.
XXXX.XX.XX...XXX.X..X..XXXX..XX....X.....X.X.XXX..XXX.X.XX....XX.X.X..XXXX.XXX.XXX....XX...X.X.X.X..X.
.XX..XX..X.......X.X..X.XX..XX..X..X.....XX.X..X.XX..XXXXXX....XXXXXX..X.XXX..X.XXXXX..X.XXXXXXX..X.XX
X...X.X.X..X..X..XX.X...XXXX..X.XX.....X....XX.X..X...XXXXX....XXX....XXXX...XXXX...X..XX...XX..X..XX.
X.X.XXXX..X...X.XXXX.X....X.X...X.....X.X.XXXXXX..X..XXXXX.XXXX..XXX.XXXXX.XXX...XX.X..XX.X...XX......
...XXX.X.XXX.X.XXXX.X..XX.XXX.X.XX......XXX.XXXX.X...X..XX.X...X.XX.X.X..X..XXX.XX..X..XXX..X.XXX..X.X
.XXX....XX.X...X.....XXX..XX.XXXXXX.X.X.XX.X.XX.......X...X.XX..X..X.XX.XX.X.X.XXXXX.X.X.X..X.XX..X.X.
XX..XX........X.X.X..X....X..X...XXX..XX...XX.XX..XX..X..XX..XXX.X.XXX...X.....XXXXXX.X.XXXX.X..XXX.XX
X.X..XX.XXXX.XX....XX.XX.XXX..X.XXX...X..XXXXXXXX....XXXX.XXXX.......XXX.X.XXXX.XXXX.X.X.XXX.XXX.XX.X.
X..XXXXX..X..X..XX...XX.X.X....X..X.X..X..XXX.X.XX.XXX.XXX.....XX.XX.X.X..XX.XX...XX.X....X.....X.XX.X
.XX.X..X..X.XXXX.....XX....XX.XXXXXXX.XXXX..X.XXX.XXXXX....XXX..XXXX....X.XXXX.X.XXXXXXX..X....X.X.X..
...XXX.....X..X.....XX.XXXXX.XXX...X..XX...X..X..XX...XXX.X.X...XXX...XXXXXXXX.X.X..X....XX..XXX.XXX.X
XXXXXX.XX......XX.XX......X.X.XX...X..X..X.X.XXXXXXX.XX.X.X..XXX...XX...X.X..XX.XX..XX...XXX..X.X...XX
XXX.XXXXXXX.X.X....XX..X..XXX..XXXXXX..X.X.XX.X.X..X.XX....XXXX...XXXX.....X.......XXX...X..XX...X.XX.
XX..X..X..X...X.XXX.XX.XXXXX.XX.XXXX...XXX.XX.X.X..XX.XXX.X.X..X.X..XXX....XXX...XX.X.X.XX..XXXXX.....
X...XXXXXXX.X..X.XX.X..XX.X....XXXX..X.XX.XXXX.X...XXX.X.X.XX.XX.....X....X.....XX...X..X.X....X..XXXX
XXX...XX.X..X.....X.X.....XXXXX.XX..XX....XXXXXX..X..XXX......XXXXX...XXXXXXXX.X.X..X.XX.X.X.X..XX.X.X
..X..X.XXX...XX.X.XX....XXX.XXXXX.X.......XX.XX.X.....X.X.XXXX.X.XXXX.X..XX.XX..XX.XX.X.X.XXXX...XXXX.
...X...XX......XXX.XXXX.....XXX.XXXX.X..X.X..X.XX.X....X...X.X...XXX..XXX..XX..X....XXXXX...X..X.X...X
X......XX...XX.XXX.XX.XXX.XX..XX..X...X...X...X..XX.X.XXXX...XXX...X.XXX..X..X...XXXX.XX.X..XXX...X.XX
X..X.......XX..XX...XX.X.XX.X....X.X..X.X....XXX...XXX.X.X.X..X.........XX..X....X.....XXX..XXX...XX..
X...XXX.......XXXXX..X.XX.XXX.X..X..X...XX.XX...XXX...X.XX..X.X....XX.....XXXX.X.X.XXXX...XX..X.XX.XXX
X.XX.X....XX.X.XXX.XXXX.XX..........XXX.X...XXX....XXX.XX..X..XXX.X.X.XX...XX..XX.XX.XX....XX.X.XX..XX
....XXXX.XXXXXX..XXXXX.XXXXXX.X..XXXX...X.......X.....X.X.X.XXXX.XXXX.X.X..XX.XX.....X...X.X..X.XX..XX
.XXXX.X.X....X.X.XXXX...X..X.XXXXX..X.X.XX.X.XX.X..X.XXXXX.X.X.......X..X.....XXXX..XX......XX.......X
.XXX.X.X..X.XXXXX...XXX.XXXX....X.X..XX...X.XX..XXX.XX.X..X...XXX.X..X.X.X.XXX..X..XXX.XXX.XXXXX.X.XXX
.X..X..X..X....XXXX.XX.X...X..X...XX...X..XXX.XXXXX...X.......XX.XXXXX.X...XXX.X.....XXX.X.XX.X....X..
..X..X......XXXX...........X...XXX.XXX....X..XXXXXX.XX.XX.XXXXXX.XXXXX.XX..X..XX.XX...XX.XX.X.XX....X.
X..X.X.X..X..X.X...XX.X.X.X.X.XX.....XXX.XX.X...XX..X.XXX..XX.....XX.X.X..XX.XXXXX..XX...XX.X.X.X.XXX.
..XX..X.X.X...X.X..X.....X....X..XX..X..XXXX...XXX..X...X....X..XX..X...X.X...X..X..X..XXX..XX..X..X..
XXX.....X..XX.....XX.X...XX..XXXX...XX..XXX.XX.X.X.XXXX.XXXXX....X.X....X.XXX.XXX..XXX.......XX....XXX
..X.X..XX...XX.....XX.....XX..XX..XXX...XX.X.XXX..X.......XXX.XX...XXX.X...X.......XXXXX.XXXX..X...X..
.X..XXXX.X.XX.X...XXXX..XX...XXXX...XX..XXX...XXXX...X.XX....XX..X.......XXXX..X..X.XX..XXX..X.XXXXXX.
..XX.X.XXXX.XXX....X.X.XX..XXXXXX.......XXXXX.X..X....X.X..X.XXXX..XXXX.X.X..XX.......XXXXXXXX.XXX.XXX
.X.........X.X.X.X..XX....X..XX..XX.X......XXXXXXX.X...X..XX....XXX.XX.XXXX.X.XXXXX...X.....X....XX...
X.XX.XXXXX....X...XXXX.XXXX.XX.XXX..X.XX.X.XX.X...X..X..XXX.X..X....XXXXX.......X.XXX.XX.XX.XXXX....XX
XXX....X..XXX.X..X...X..XXX..XXXXX.XX..X..XX.X...X.X.X.XX.....X.X.X.XX.X.X.XX..XX.XX.X..XX...XXX.XX.X.
...X.XX.X..XXX.XXX.X...X...X.XXX.XXXXXX.X...X...X..X.XX...X.XX.X.X.X.X.XX..X..XX...X....XX..XX..XXX...
....XXXX..XXX..X.XXX.XXXX.X.....X.X.X.X....X.XXX.X....X.XX...X......X...XXXX..X.XXXX...XX..X.XXXX..XXX
X..XX.XXX..X.XXX.XXX.XXXXXXX.....XX.XXX...X.XXXX....XX..X...XX..X.X..XX.XXXX.XXXXX.XXX...X..XXX..X.XXX
XX..XXXXXXX..X.X...X..X.XXX...X.....XX....X.XXX.XX.X.X....XXX....XX..XX.X.XXXXXX..XXX.X...XX.XX.X.XXXX
.....X.XX.XX.XX....XX.X.XXXXX.X.XX.X..XX.X......XXX..XX...XX.X.X..X..X.X..X..X.XX..XXXX.X..X.XX.XXX.X.
X..XX..X.XX...XXXX.XX...X..X......X..X...X.XX..XXX....X.XXX....X.X.XXXX..XX.XX.XXX.....X........X.X..X
...XX.X...X.X.X..X.X.X.X..XXX.XXX..XXXXXX.XX...XX.X.X.XXX........XX....XX.X.XXX.X.XXXX.X...XX.X..XX.XX
XXXXX...X..X..X...X.X....X..XXX....X...X.X.X.X........XX.X.....X.XX.XX...X..XXXXXX.X.XX.X.XXXXXXX.X...
X...XXXX.XXXX..X...X.X..XX......XXXX.X.XXXXX.X..XXX.XX...X...X.X...X....X...XXXXXXXXXX..XX....X..XX...
.X.X.XXX..X..X.....XXXXX.XX.XXXX.XXX..XXXX...X.XX...X.XX.....X...X.XXXXXXXX....X...X.X...XXX.X.X.XXX.X
.XXXXXX...XXX..X..XX...X..X.XXXX.XX..XX.X..X.XX.X..X..X...XXXXX...X..X.XXXX..XXXX...X.X.XX.XX..XX.X...
XX...X..XX..XXX.XX...X..X.XX.XX...XX.X..X.X...XXX.X.X.XXXXXX..XXX.XXXXX.X.X.X...X...X..X.XX.X..XXX.XXX
.X..XXXX..XXXX..X.....XX..XX.X....X.XXXX...X.XX....X.X..XXXXXX...XXX.XX.XX..XX.XX.XX.XXXXXX..XXXXX.XX.
.XX.X.....XX.X..X.XX.....XXX.XX.XXXX..XX..X..X..XXXXX..X....X.XXXX...XXXXXXXX..X....X....X..X..XXXX.XX
XXXX..XXXX..XX.X.X..XX...X....X..XXXX.XXX.X..X.XXX.X.X..X.X.XXX.....X.X.XX..X...X...XXX.XXXXXXX.X...XX
.X.XX.....XXX..X.X....X....XX..XX.XXX.X..X..X..X.XXX.XX.XX..XX.X.X.XX..X.X..X....XX..X...XXX...XX.XXXX
XX.X....X.X.XXXX.XX.......XX..XX........XX..X....XXX..XX......XXX..X.X.X....XXX.XX..XX.X.XX.XX.XXXX..X
..X.XX.X.XX....X.XX.X....X..X...XXXXX.XXXX.X...XX..X..X.X.X.....X.X..X.X.XX....XX..XX..X.XX.X.XXX.XX..
.X....XXX..XX.X.XXX.XX..X.X.X..XX..XX....X.X..XXX....X....XX.X.X.X..XX.XXXX.X.XXXX.XX.X...XXXX.....XX.
.X.....XXXXXXXXXX...X.XX.XXX.X....XX....X..X.X...X.XXXXXXXXXXXXX....XX..X.X..XXXXXXXX.....X...X......X
XX.XX....XXX..XXXXXX.X..XX.X..X..X..XX..XXXX....X....X.XX.XXXXX.X.XXX.XXXX.XX....X....X..XXX....X.XX..
XX.X.X...XXX.X...X.XX.X.X.X.XXXXX....XX.XX.XXX..XXX..X...XXX.X.X.XX.XX.X.XXXX.X..X...X.....X..X.......
...XX.X..XX.X.X..XX.XXXX.XX...X....X....X.X..XXXX....XXX....XXXX.X...X.X..XXXXXX..X.XX..X...X.X.XXXXX.
...X.X.XXXX..XXXXXX..XX..X.XXX.XX..X..XXX.X.X.X.XXXXX.X.X..X.XXX.XX...X..........XXX...X..X......XX.X.
X....XXX.XXXXX.X...X.XX.X...X...XX..XX.X.XXX...X..X.X...XXXXX..X.X.XX.X.X....X.X..X.XXX..XXXX.X..XXXX.
XXX..XX.X...X..X......X.X.XX.XX..XX...X....XX.XX.X.X...X.X.XXX..XX.X...XX..XX.X...XX.X......X...X.X...
.XXX.XX.....XXXXXX.XXXX.XX.X.X..X....X...XXXXX.X..XX.X.X.XXX.X....XXXXXXX.X.X....X.X.XX..XX....X....X.
X...X.X......XXXXXX..X......XX.XXX.....XXXXXX.X.X..XXX..XXX...XXXXXX.X.X.X..X.XX.X...X...X..XX....XXX.
.X.X....X..XXX.XX.XXX.....XXXX...X.....X....X....X..X.X.XX...X.X...X...XXX..X...XX..X..X.X..XXXXX..X.X
X..X..X..XXX.....X....XX.XXX...X.X.XX.XX.XXX.X..X..X.XX...XXX....X.X..X..X.XXXX..X....XX..X.X.XX.XX.XX
XXX.X..XXX.XXXXX.X....XXX.XXX...X...XXX.......X.X.X..XX...X...X...XXX....X.X.XX.XX.XXX...X.X..XX......
..X.X.XX...X.XX..XX.X.X.XXX.XXXX.XXX...X....XXXX...X........XX.X..XXXXXXXXXX......X.X..XXXXX..XXX.X..X
..X..X.X..X..X......X.XX....X.XXXX..XXXXX..X..X...X.XXX.X...XX.X..X..XX.XX..XXXX..X..X.XXXXX...X.XXX.X
.X.XX.X..X.XXXXX.X.X.....XX..XXXX.XXXX.XX.XXXXX...X..XXXX.XXX.X..X..X.X.XX..X.XX.XX.XX....X.X.X....X.X
.....XX...X.XX..XX...X.X.XXXX...X.XX...XX.X.X....X..XX.XXX......X.XX.X.....XXXX...XX.XX.X..XXX.XX..XXX
XX..X.X....XXX..XXX....XX.X.....X...XXX...X.X..XXX.X......X..XXX..X.XX.XXX....X.XXX.X.X...XX......XX.X
XXX..XX.X.XXX...X.XX.XXXX.XX..XXX...XXXX....XXX.X...XX.X.X.X.X....XX..X.XX.XXX.X.......XX...XX.......X
.X.XXX...X.....X......XXX.X.XX.X.X...X....X.X..XXX.X..X..X.XXX.XX.X...XX.XX.XX.X..XX...X.......XX.XX.S
10404
