102
E.X.X.X.....X......X....X........X..X.XX.........X..X......X.X.........X....X......X.X...........X..X.
............X...X.X.......XXX......X....XX......X.......X................XX.XX..........X........X....
X....X..............X.....X.......XX...........X.....X...........X....X.X........X.XX.X.XXX....X..X...
..X.......X.X..X.X....X......X......XX..X.......X..XXXX....X...X..XX..X...XX...............X..X.......
X......................X.XXXXX.XXX.X...............X.........X.XX..........X..XXXX.X...XX......X......
X..XX.X...X.X.X......X.....X...XX.X...X....X.....X.....XX.X....XXX....XXX...........X.....X.XXX.......
...............XX....X...X..X..XX..X.X......X...X.X...X..........X..X.X........X.XXXX...X.....X.......
........X....X..............X...X...X........X....X.X...X........X..X...X..X....X...XXX........X......
X...............X..X....X.X.XX.........X.......X...............X.............X.......X........X.X.....
.X.....................XX.....X.....XX..X.X..X...XX.........XXX..X...XX.................X.............
...........X..X....XX..X....X..X.....X...X.............X....X............X.....X...X.X...X............
....X....X.X..X...X...X.X...............X....X.X..X..X........X.X....X..X.X.......X.......X....X..X...
.X.X.......X.XX..X.......XX.......X...X......X....X.............X...X.X..............XX...X...........
...X..........X.........X.....XX......X.....X.X.X.....X.....X.............X..X....X.X.........XXX..XX.
......X..X.........X...X.X...X..X.............X........X..........XX.......X...X........X......X......
..X...X......X..X.X.....X...X...X.....X.......X...................X....XX.....XXX..XX.....XXX......X..
X...X...X.............X...X.X....X......X..X...X..X....X.X....X..X......X............X...............X
X....X......XX.X....XXX..X..X.X...X.......X.....X..X...X..X......X............X.X...XX..........X.....
.X.XX.X....X....X..X.X.X..X...XX....X....X.X.X.......................X.X....X...X.X...................
...X..X...X....X.......XX..X........X...X...X...................X.X.....XX..X.....XX...X......X.....XX
...X.......X...X...X.........X......XX..X...XXXXX....X.X....X.....X...X..................XX...X..X....
........X......X...X...X..XX..X.X.X.X....X.........X.....X.........X..X...X............X.X...X........
....X...........X....X....X....X....XX....X..X.....X.....X.X...........X....X..........X.XX.X.........
..X..XX...XX.....X..X.......X......X.....X.....................X........X....XX..........X...........X
..................XX...X.....X...........X.......X......X.X.....X........XXX............X.X.X.........
XX.....XX.X......X.XXXX....X.XX..X....X.......X..X.X....X...X...X..X.....X.X......XX....X.......X...XX
....X.X.......X.......X.....X......XXX....X.......X........X.............X.X......X....X....X..X......
......X.X......XX............X....X..........X........X.XX..X...........X.XX...X.X....X...X.........X.
...XXXXX.X.....X.........X.......................X.X..............X.X...X..X....X...X.X.X..XX......X..
.X.....X...X...X..........X.XX..XX........XX..............X.X...X...X.....X.....X......X.X..X.........
.X.X..XX......X.........X...XX......X........X.X.........X........X..XX.X.....XX.X..X........X.X.X...X
..X..X..............X.X....X....X...XX...X...X..XX...X.................X...X...XXX....X....X.....X..X.
X..X.....X..X.......XX.X...X...XX.........X.X..XXX...X.X...X...........X...XXX.X...X......X..XX.....X.
....X.......X.X..............X........................XX.X........X.X..X........X.X.....XXX...........
....X....X....X.....X.X.............X.XX...X.....X...X..X..X...XX...........X......X.....X.........X..
..XX.X.X......XX.....X.XX...X.X...........XX.............XX......X......X...............X...XX........
...XX.............X....X..........X...X....X..XX....X.X.XX....X.XX......X......X......X.....XX.....X..
X.X......X....XX......X...X.X.....X..X..........XXX..........XX....XX.....XX......X...X..X...XX......X
X.X..........X..X..X....X....X.X....X....X.XXX.X.......X..X..........XX........XX.X.........X...XX....
.................X.X.....................X..........X...X...X..........X.X.X.X..X.X...X.X.X......X....
.......X....XX.....XX......X.X.X.XX.....................XX.............X..X......XXX..XX.....XX....X.X
........X...X........X...X....XX.......X....X.......X.......X.........X..................X..X......X..
.XX..X.......X....XX.....XX.X.........X.X.....X.....X...X....X.....X....X...X....X.........X.....X....
..X.....X.......X......X.....X........X.......X...X..X....X...X.....X.X.X.....X...X.....X.X........X..
X....X..X......X.....XX.......X.X.X...XX..X....X..XXX...........X....................X.X.X...X.X.X...X
.X.X...............X..X.............X..........X...X......X............X.XXX.XXX........X....X.X..X...
XX.......X.....X..X..X........X.....XX..X..............X....X.X.X.........XX.X...X.XX....X.X.........X
...X............................X...........X....X.....X...X..X....XX...XXX........X.............X.XX.
..XX...XX.X..XX......XX...X.......XX.X.X..X.X.X...................X....X.....XX...........XX.XX...X...
...........XXX.XX....................XX......X..X.....XX.........XXX...X......X...X.....X..X......X..X
..X.X.......X..XXX.....X..........XX.......X...............X.X...X.XX.......X.....X..X...X............
........X.......XX...X...X..X.....X........X...X...........X.........XXX.....X.......X...X..X.X..X.X..
..X.X....X...X......X..X..X......X....X.X..X....X..........XXX.........X.X...X........X.........X.....
X.......X..XX..X.......XX.......XX...X........XX.......X...X...X.....X..X.......X.....................
......XX.....X..X..............X.XXX.X.........X.X.......X....X............X..XX.....X..X.........X...
....XX......X...X..XX.X....X.......X..X....XX.....X.....X.X...X...........X....X..X....X...X....X.X...
.......X..X..X.XX...XX..XXX..X........X........XXX..X..XX....X...........X....X........XX..X..........
....X......X.X...X........X.....XX......X..X.............XX.........XXX.......X.X.X........X.X.XXXX...
.......X.......X.........X..X...........X.X.....X...X..X...X..X.XX........XX.XX....X...........X......
..............X.X.........X...................X.......X.X.......X..X....X.X...X....X............X....X
..X.....X...X..........X.X..X..XX.X.X........X........X..X.....X....X..XX..XX.X...............X.......
...X......X..X.....X....X.................X....X.......X..........XX...........X..X.XXXXX...XX....XX.X
..X.X.......X.X.....XX......X.XX...X.......X.........X.....X......X.......X.XX.X......X.........XX...X
.......X......X.XX....X..........XXX..X..X...........X..X.X............X.X........XX......X.....XX....
X.X.........X...X..X...X..X...XX.....X...X...X...X.....X..X............X.X....X.........X.X...X.......
.............X...XXX...............X.......X.........X........X....X.X...................X........X...
......X.....X.......X.....X.....X..X.........X..X...X...............X.X........XX..X......X.X...X.X.XX
...X.X....X.............X.X..X......................XXXXX...X.........X.....X................X........
.X.....X........X......XXX.X....X............XX......XX..............XX..X..XX..X.XX.........X..X.....
X....X...X...........X........XX.......XX..X...X...X.X..............X....X.X...X....XX.....X.X........
.X.......X.X..X................X..X........XX..X.......X....X....X.X.X.X.X...X....XX.....X.XX.........
......XX..........X........XX.......XXX...X......X...XX.X.X...X.....X..........X.....X..........X...X.
XX.X.....X...XX......XXX.....X..X...........X..............X.........X..X....X.....XXXX..X...X........
X....X..............X.....X....X.........X.X.....XX...XX....X.X....X......X.XX...XX......X....X.......
.XX......X..X.............XX..............X...X.XX...XX......X.......X..X......X..X.............X..XX.
.........X....X..XX.........XX....X.XXX........XX.XX................X.XXX.........X.X..X..X...........
....X.XX.....X..X.XX.....X......X....X.X.....................X..XX...........X...X......X..XX.........
..X...X..X....X..XX................XX.X.X..X..X....X...X...XX.X...X.X......XXX...X.......X....X..X.X..
.....X.X...X.X..X....XX....XX..X.X.........X..X..XX....X.X...XX.........XX...X.X............X......X..
......XX..X...XXX.X.......X...X....X.....X.............X.XX.............X...X.XXXX....X.XX.....X..X.XX
.X.....X..X..X..........XX.....X....X.......X..........X...X.........X..XX..XX...........X....X...X...
X..........XX...X.....XX.X.X...XX..XX.X.....X.X.......XX....X.XX.........X.X.X.....X.X..........X..X.X
.....X.........X......X..X..X.XXX.XX..X...X....X..X............X..X....X....XX...X.X.....X........X...
.X..X..XX........XX....X....X.......XXX...X...X..X.X.X...XX...........X..XX...X..X.......X......X....X
.....X..X...X.......X.......X.XXX.....XX....X...X...X..X.X..X......X.X.X.X.X.....................X...X
X....XX.......X.X....................X..X............X.X...........X..X....X.X............X...........
.........X......XX......X....XX.....X......XX...X....X............XX...X..X....X.................X..X.
.XX.....X......XX..X.....X.............X......X....XXX....X.XX..X.X.X...X...........X..X..X..X........
X..XXX..X.XX.........X...X.....X...X....X.........X..........X...X...XX..X..........XX........X..X....
....X..X.............X.X.....X..X....X.................................XX.......X.......X...X..X.....X
.X.X....X..............X...X.....X.......X..XX......X..X.X...X..X..X.............X...XX...............
.X..XX..X.....XX..XX..X.X...X...XX..............X......X.........X......XX..X...............XX.......X
.X..X.X...X........X....X.............X.X..XX.X........X......X..X.....X....X.......X................X
...XXX.X...................X...........X..XXX.X............................X......X.......XX..........
......XX.X.........XXX...X....X.X.X.........XX..X......XX......X.X........X......X.XX..XX.X..........X
...........X..X.X...X..X.X.....XX.X.....X......X.X...X..X..X..X.........X..........X......X...X.X.X...
.X..X.X.......X..............X..X..X.....X.......X.XX..X...X...X.X.......X.X...X..X.........X..X......
.....XX.............X.X........X.........X.....XX.....X........X...X.......................XX.......X.
.X..X..XX.......X............X...X.........XX.........X.X.....X..XX..X....X.....X..X......XX.X........
.......X.....X....X.X...X........X.X.....X...............XXX........X.....................X.X.X..X....
.X.............X...X..X.XXX.X.X.X..X.....X...X...X.X......XX..X..X............X...X.......XXXXXX......
..X...X..X.....X...........X............XX..........X...X...X...........XX....X...X......X.X.........S
10404
